bleak			мрачный
oblong			продолговатый
ruddy			румяный
slouch			сутулый
endow			наделять
forlorn			покинутый
pensive			задумчивый
swagger			развязный
brood			выводок
remorse			сожаление, сожалеть
hilt			рукоять, эфес
contented		удовлетворенный
dismay			тревога
fathom			осознать, вникать
dejectedly		удрученно, подавленно
wanly			тускло		
slither			скользить, ползти
gruff			грубоватый, хриплый
meticulous		тщательно, дотошно
plop			бултыхнуться, плюхнуться
comb			расческа
hamlet			деревушка
poised			уравновешенно, с достоинством
aloof			равнодушно, отчужденно
clad			одетый, облаченный
louse			вошь
wily			коварный
scanity
anoint
flail
sickle
swathe
profusely
pout
infatuated


thinktwicethendo
